{
    "id": "sample-1",
    "width": 10,
    "height": 10,
    "tileSheetId": "default",
    "tileIds": [
        [12,   0,   0,   0,    0,  0 ,   0,   0,   0, 12],
        [12,   76,  76,  76,  76,  76,  76,  76,  76, 12],
        [12,   76,  76,  76,  76,  76,  76,  76,  76, 12],
        [12,   76,  76,  76,  76,  76,  76,  76,  76, 12],
        [12,   76,  76,  76,  76,  55,  76,  76,  76, 12],
        [12,   76,  76,  76,  55,  55,  55,  76,  76, 12],
        [12,   76,  76,  76,  76,  76,  76,  76,  76, 12],
        [12,   76,  76,  76,  76,  76,  76,  76,  76, 12],
        [12,   76,  76,  76,  76,  76,  76,  76,  76, 12],
        [115, 103, 103, 103, 103, 103, 103, 103, 103, 91]
    ]
}